NO assets/textures/achretie.xpm
SO assets/textures/alprival.xpm
WE assets/textures/cmieuzet.xpm
EA assets/textures/pmailly.xpm
PO assets/textures/vnaud.xpm

F 80,20,20
C 0,0,0

        1111111111111111111111111
        1000000000110000000000001
        1011000001110000000000001
        1001000000200000000000001
111111111011000001110000000000001
100000000000000001112111111111111
11110111111111011100000010001
11110111111111011101010010001
11000000110101011100000010001
10000000000000000000000020001
10000000000000001101010010001
11000001110101011111011110S0111
11110111 1110101 101111010001
11111111 1111111 111111111111
