NO assets/textures/blue.xpm
SO assets/textures/red.xpm
WE assets/textures/green.xpm
EA assets/textures/yellow.xpm

F 220,100,0
C 220,0,255

111111111111
100000000001
100001100001
100000100001
10000N000001
100000000001
111111111111