NO assets/textures/blue.xpm
SO assets/textures/red.xpm
WE assets/textures/green.xpm
EA assets/textures/yellow.xpm

F 220,100,0
C 220,0,255

111111
100101
10110
110001
111111
